2 2 2 1 2 2 2
1 3 1 7 1 1 1
1 1 1 1 1 3 1
1 1 4 5 4 1 1
1 3 1 1 1 1 1
1 1 1 7 1 3 1
2 2 2 1 2 2 2