6 6 6 1 6 6 6
6 6 6 2 6 6 6
6 6 6 2 6 6 6
6 6 6 4 6 6 6
6 6 6 2 6 6 6
6 6 6 2 6 6 6
6 6 6 1 6 6 6