2 2 2 1 2 2 2
1 3 1 1 1 1 1
1 1 1 1 1 3 1
1 1 4 6 4 1 1
1 3 1 1 1 1 1
1 1 1 1 1 3 1
2 2 2 1 2 2 2